size 4
wumpus_rotation 1 clockwise

+-----+-----+-----+-----+
|                       |
|                       |
+     +     +     +     +
|        G   W          |
|        1   1          |
+     +     +     +     +
|           |           |
|           |           |
+     +-----+     +     +
|     |                P|
|     |                 |
+-----+-----+-----+-----+
