size 4
wumpus_rotation 1 static

+-----+-----+-----+-----+
|                  W    |
|                  1    |
+     +     +     +     +
|        G              |
|        1              |
+     +     +     +     +
|                       |
|                       |
+     +     +     +     +
|                       |
|                       |
+-----+-----+-----+-----+
