size 4
wumpus_rotation 1 static

+-----+-----+-----+-----+
|                      P|
|                       |
+     +     +     +     +
|W       G       P      |
|1       1              |
+     +     +     +-----+
|     |           |     |
|     |           |     |
+     +     +-----+     +
|                       |
|                       |
+-----+-----+-----+-----+
